#########################################
#     #           #     #   #           #
### # ####### ### # ### # # ########### #
#   # #     # #   # #   # #         #   #
# ### # ### # ### # # ### ######### # # #
# # # # #   #   #   # #     #       # # #
# # # # # ##### ##### # ##### ####### # #
# #     # #     #     # #     #       # #
# ####### # ##### ##### # ##### ####### #
#       #   #   #   #   #   #   #       #
# ##### ##### # ### # ##### ### # #######
#     # # #   #   # # #     #   # #     #
####### # # # ##### # # ##### ### # ### #
#   #   # # #       # #     # # # # #   #
# # # ### # ######### ##### # # # # # ###
# #   #   # #   #   #   #   # #   # #   #
# ####### # # # # ##### # ### # ####### #
#   #   #   # #   #     # #   # #     # #
# # # # # ### # ### ##### ### # # ### # #
# #   # # #   # #       # #   #   # # # #
####### # # ### # ##### # # ####### # # #
#       # #   # #   # # # # #   #   # # #
# ####### ### ##### # ### # ### # # # # #
#   #   #   # #     # #   #   #   # # # #
# # ### ### # # ##### # ##### # ### # # #
# # #     #   #     # # #     # # #   # #
# # # # ##### ##### # # ### ### # ##### #
# # # # #     #     #   #   # #   #   # #
# # # ### ##### ######### ### ### # # # #
# # #   #   #   #     #     #     # # # #
### ### # ### ##### # ### # # ##### # # #
#   #   # #   #     #   # # # #     # # #
# ### ### # ##### ##### ### # # ### # # #
# # O     #     # #   #     # #   # #   #
# ############# # # # ####### ### # ### #
# #       #   # #   # # #   # #   #   # #
# # ##### # # # # ### # # # # ##### # # #
# # #   # # # # # #   #   #   #   # # # #
# # ### # # # # ### ### ####### # ### # #
#       #   #       #           #     # #
#########################################